----------------------------------------------------------------------------------------------------------------------------------------------------------------------------------------
----------------------------------------------------------------------------------------------------------------------------------------------------------------------------------------
----------------------------------------------------------------------------------------------------------------------------------------------------------------------------------------
----------------------------------------------------------------------------------------------------------------------------------------------------------------------------------------
----------------------------------------------------------------------------------------------------------------------------------------------------------------------------------------
----------------------------------------------------------------------------------------------------------------------------------------------------------------------------------------
-----------------------------US-----------------------------------------------------y---------------------2--------------------------------------------------------------###------------
----------------------------------------------------------------------------------#SSS---------------------------------------------------------y-------------------------###------------
---------------------------------------------------------------------oo----------##------------------------------------y---------------------#SS--o-------------------y--###------------
-----------------------------------------------------------------y--------------###1--------------ooo------------------#SS-?Q---------------##------------------------#--###------------
---------QQ-----------------####--SSC------------------ooo-------##-------------###-----------------------2-----------##-------------------###--SC-------------------##--###------------
-----------------------y-#####----------------------------------###-----------#-###--SSS-------TT--------------------###------------------####---------------------y###--###------------
--------------------y-######-----------------------------------####----------##-###------------TT-------------------####-------y---------#####---SSS---------------####--###--------F---
-------------------#######------------------y-y---------------#####-------------###---------y--TT-------y--y-------#####---SSSSS-----y--######--------------------#####--###--------#---
XXXXXXXXXXXXX--XXXXXXXXX------XX--XXXXXXXXXXXXXXXX--XXXXXXXXXXXXXXX---XXXXXXXXXXXXXXXX---XXXXXXXXXXXXXXXXXXXXXXXXXXXXXXX-------XX-XXXXXXXXXXXX------XXXXXXXXX---XXXXXXX--XXXXXXXXXXXXXXX
XXXXXXXXXXXXX--XXXXXXXXX------XX--XXXXXXXXXXXXXXXX--XXXXXXXXXXXXXXX---XXXXXXXXXXXXXXXX---XXXXXXXXXXXXXXXXXXXXXXXXXXXXXXX-------XX-XXXXXXXXXXXX------XXXXXXXXX---XXXXXXX--XXXXXXXXXXXXXXX