--------------------------------------------------------------------------------------------------------------------------------------------------------------##
--------------------------------------------------------------------------------------------------------------------------------------------------------------##
--------------------------------------------------------------------------------------------------------------------------------------------------------------##
--------------------------------------------------------------------------------------------------------------------------------------------------------------##
------------------------######-MMMMMMMMMMMMMMMMMM-----------------------------------------------------##------##----------------------------------------------##
------------------------######------------------------------------------------------------------------##------##----------------------------------------------##
--------------------##########----------------------------------------------------------------------######--####----------------------------------------------##
--------------------##########----------------------------------------------------------------------######L-####----------------------------------------------##
--------------################---------MMMMMMM-MMMMMMM-MM-------------------------------------##################--------------#############--##---##########--##
--------------################----------------------------------------------------------------##################--------------###----#---#---#-----#-#---###--##
------------##################--------------------------------------------------------------####################------------#####----#---#---#-----#-#---####-##
--------P---##################--------------------------------------------------------------####################------------#####----#---#---#-----#-#---###--##
##############################-----------------MMMM-MMM-MMM-MMM-MMM-MM----#######################################################----#---#---#-----#-#---###--##
##############################--------------------------------------------#######################################################----#---#---#--HHH#H#HHH###--##
##############################--------------------------------------------#######################################################----#---#---#--############-###