--------------------------------------------------------------------------------------------------------------|#
--------------------------------------------------------------------------------------------------------------|#
--------------------------------------------------------------------------------------------------------------|#
--------------------------------------------------------------------------------------------------------------|#
-------------------------------------------------------------------------------------------------------#########
--------------------------------------------------------------------------------------------------##---------##-
------------------------####-----------------------------------------------------------------ll-----------######
------------------------####-----------------------------------------------------------------##-------#----#####
--------------------##########--------------------##------##------##------##--------##---######-------------####
--------------------########----------------------##------##------##------##--------##-----------------------##-
----------------################----------------####----####----####----####------####---------------#------W###
-------P----------------########----------------####------##----####------##--------##---------------------#####
####################################################--######--######--######--##################################
----####----------------####--------####----------##--######------##--######--------###########--------------##-
####################################################------##--######------##--##################################