------------------------------------------------------------------------------------------------------------------------------------------------------------------------------------------------------------------------------------------------------------------------------------------------------------------------------------------------------------------------------------------------------------------------------------------------------------------------------------------------------------------------------
------------------------------------------------------------------------------------------------------------------------------------------------------------------------------------------------------------------------------------------------------------------------------------------------------------------------------------------------------------------------------------------------------------------------------------------------------------------------------------------------------------------------------
------------------------------------------------------------------------------------------------------------------------------------------------------------------------------------------------------------------------------------------------------------------------------------------------------------------------------------------------------------------------------------------------------------------------------------------------------------------------------------------------------------------------------
----------------------------------------------------------------------------------------------------------------------------------------------------------------------------------------------------------S-----SSSSSSSSSSSSSSSSSSSSSSSSSSSSSSSSSSSSSSSSSSSSSSSSSSSSSSSSSSSSSSSSSSSSSSSSSSSSSSSSSSSLSSSSSSSSSSSSSSSSSSSSSSSSSSSSSSSSSSSSSSSSSSSSSSSS----------------------------------------------------oo--------------------------------------------------------------------------------------------------------------------
----------------------------------------------------------------------------------------------------------------------------------------------------------------------------------------------------------S-----------------------------------------------------SS--SSSSSS--SSSS------SSSS---------------------------------------------------------------------------------------------------------------------g-g------------------------------------------------------------------------------------------------------------
----------------------------------------------------------------------------------g-----------------------------------------------------------------------------------------------------------------------S-----------------------------------------------------SS--SSSSSS--SSSS---g--SSSS----------------------------------------------------------------------------------------------------ooor---------%%%%%%%-------------oooo----------R------------------oo--oo--------------------------------------------------------
----------------------!---------------------------------------------------------SSSSSSSS---SSS!--------------@-----------SSS----S!!S--------------------------------------------------------##------------S----------------------------------------oooo-------SS--------SS---S----SS----------oooooo--------------------------------------------------SSS------------------------------------%%%%%----------|||||--------------%%%%----------------g----oo---------------------------R-----oo--------------------##-----------
-------------------------------------------------------------------------------------------------------------------------------------------------------------------------------------------###------------S---------------------------------------------------SS--------SS---S----SS----------------------------------------------------------------------------------------------------------|||-----------|||||----oo---SSSS--||-------------%%%%%%----------------------------r-------------------------------##-----------
-------------------------------------------------------------------------------g----------------------------------------------------------------------------------------------------------####------------S--------------------------------------S-SSSS-U-----SS--------SS---S----SS----------SSSSSS------------------------------------------------------------------------------------------|||-----------|||||---------------||--------------||||-----------------------%%%%%%%%----------------------------####-----------
----------------------------------------------------------------1------------------------------------------------------------------------------------------------------------------------#####------------S----------------------------C---------SoS--SoS-----SS----ooooSS---SoU--SC--g-g-----SSSSSS-------------------------------------------------------SSSSSSU----------------------------|||-----%%%%%-|||||---------------||--------------||||-----SSS----------------||||||---------------------SSS-----####-----------
----------------!---S@S!S---------------------tt---------tt------------------S@S--------------C-----SU----!--!--!-----S----------SS------#--#----------##--#------------SS!S------------######------------S---------@QQQQ--------#-#-------------SSS--SSS-----SSSS--SSSSSS---SSS--SS--SSSS-----------------------------TT------------------------g##---------------------------------------%%%%%%%%----|||--|||||---------------||-------%%%----||||-------------SSS--------||||||-----%%%%--%%%%------------######-----------
--------------------------------------tt------tt---------tt-----------------------------------------------------------------------------##--##--------###--##--------------------------#######------------S--------------------#-#-#-#---#----------------------SS-----------------------------------------------TT----TT-----------SS-----------###----------------------------------------||||||-----|||--|||||-------------U-||--------|-----||||------------------------||||||------||----||-------------######-----------
----------------------------tt--------tt------tt---------tt----------------------------------------------------------------------------###--###------####--###-----tt--------------tt-########--------F---S----------------g-#-#-#-#-#---#-#--------------------SS-----------------------------------------------TT----TT----TT-----SS---------g####--SSS-----------------------------------||||||--o--|||--|||||---------------||--------|-----||||-----------------%%%%---||||||------||----||-------------######--------F--
---M-----------------g------tt--------tt-g----tt-----g-g-tt------------------------------------g-g--------k-----------------gg-g-g----####--####----#####--####----tt---------gg---tt#########--------#---S--M------------g#-#-#-#-#-#-E-#-#--------kk----------------k--g-g------------------------------g-g-g--TT----TT--g-TT-----SS---------#####---------r--------F--------------%%%%---||||||-%%%-|||--|||||---------------||--------|-----||||------------------||----||||||--ooo-||----||---------r---######--------#--
XXXXXXXXXXXXXXXXXXXXXXXXXXXXXXXXXXXXXXXXXXXXXXXXXXXXXXXXXXXXXXXXXXXXX--XXXXXXXXXXXXXXX---XXXXXXXXXXXXXXXXXXXXXXXXXXXXXXXXXXXXXXXXXXXXXXXXXXXXXXXXXXXXXXXX--XXXXXXXXXXXXXXXXXXXXXXXXXXXXXXXXXXXXXXXXXXXXXXXXXXXXXXXXXXXXXXXXXXXXXXXXXXXXXXXXXXXXXXXXXXXXXXXXXXXXXXXXXXXXXXXXXXXXXXXXXXXXXXX---XXXXXXXXXXXXXXXXXXXXXXXXXXXXXXXXXXXXX--XX--XXXXXXXXXXXX-------XXXXXXXX--XXXXXXXXXXXXXX---||----||||||--|--|||--|||||----%%%%-----%%%%%-%%%%%-|-----||||------------------||----||||||--%%%-||----||----XXXXXXXXXXXXXXXXXXXXXXXXXX
XXXXXXXXXXXXXXXXXXXXXXXXXXXXXXXXXXXXXXXXXXXXXXXXXXXXXXXXXXXXXXXXXXXXX--XXXXXXXXXXXXXXX---XXXXXXXXXXXXXXXXXXXXXXXXXXXXXXXXXXXXXXXXXXXXXXXXXXXXXXXXXXXXXXXX--XXXXXXXXXXXXXXXXXXXXXXXXXXXXXXXXXXXXXXXXXXXXXXXXXXXXXXXXXXXXXXXXXXXXXXXXXXXXXXXXXXXXXXXXXXXXXXXXXXXXXXXXXXXXXXXXXXXXXXXXXXXXXXX---XXXXXXXXXXXXXXXXXXXXXXXXXXXXXXXXXXXXX--XX--XXXXXXXXXXXX-------XXXXXXXX--XXXXXXXXXXXXXX---||----||||||--|--|||--|||||-----||-------|||---|||--|-----||||------------------||----||||||---|--||----||----XXXXXXXXXXXXXXXXXXXXXXXXXX