-----------------------------------------------------------------------------------------------------------------------------------------------------------------------------------------------------
-----------------------------------------------------------------------------------------------------------------------------------------------------------------------------------------------------
-----------------------------------------------------------------------------------------------------------------------------------------------------------------------------------------------------
-----------------------------------------------------------------------------------------------------------------------------------------------------------------------------------------------------
---------------------------------------------------------------------------------------------------------------------------------------------------------------------------------------##------------
---------------------------------------------------------------------------------------------------------------------------------------------------------------------------------------##------------
---------------------LSSS---------------------QQQQQ-----------USSS--------SSCSS------SSSS-----------------------------USSS-----------------------------------SSSSS---?-------------C---##------------
---------------------------------------------------------------------------------------------------------------------------------------------------------------------------------------##------------
-----------------g---------------------------------------------------------------------------------------------------------------------------------------------------------------------##------------
-----------------#------------------------------k-----------------------------------------------g-------------------E------TT----------------------------------------------------------##------------
--------SUS-----##---2-----#-----------TT-----?QQQQ----------S-----TT---QQQQ--QQQ---------------TT-----------------TT------TT-----------------------------C--------Q--------------SS---##------------
---------------###---------#-----------TT--------------------------TT---------------------------TT----------g------TT--tt--TT----------------------#---------------------TT------------##------------
--------------####---------##----------TT--------------------------TT---------------------------TT----------TT-----TT--tt--TT------------------K---#---------------------TT------------##--------F---
--M----------#####----kk---##---gg-----TT------------gg----k-ggg---TT------------ggg------------TT----------TT--g--TT--tt--TT-----k----------------#-----gg-------K-K----TT--------k---##--------X---
XXXXXXXXXXXXXXXXXXXXXXXXXXXXXXXXXXXXXXXXXXXXXXXXXXXXXXXXXXXXXXXXXXXXXXXXXXXXXXXXXXXXX----XXXXXXXXXX---XXXXXXXXXXXXXXXXXXXXXXXXXXXXXX---XXXXXXXXXX--XXXXXXXXXXXXXXXXXXXXXXXXXXXXXXXXXXXXXXXXXXXXXXXXXX
XXXXXXXXXXXXXXXXXXXXXXXXXXXXXXXXXXXXXXXXXXXXXXXXXXXXXXXXXXXXXXXXXXXXXXXXXXXXXXXXXXXXX----XXXXXXXXXX---XXXXXXXXXXXXXXXXXXXXXXXXXXXXXX---XXXXXXXXXX--XXXXXXXXXXXXXXXXXXXXXXXXXXXXXXXXXXXXXXXXXXXXXXXXXX