--------------------------------------------------------------------------------------------------------------------------------------------------------------------------------
--------------------------------------------------------------------------------------------------------------------------------------------------------------------------------
--------------------------------------------------------------------------------------------------------------------------------------------------------------------------------
------------------------------------------------------------------------------------------------------------------------------------------------U-------------------------------
--------------------------------------------------------------------------------------------------------------------------------------------------------------------------------
--------------------------------------------------------------------------------K---------------------------------------------------------------------------------k-------------
--------------------USS-----------------------------------------------------SSSSSS----1----------------------------------------SSSSS------------------------------##------------
--------------------------------------------------------------------------------------------------------------------------------------------------SS-------------###------------
---------------------------------------------------------*---------------------------------------------------------------------------------------------#--------####------------
---------------------------------------------------------*-------------------K--------------------------------------------------K-------------SS------##-------#####------------
--------------------------------QQQQ-------------------SS#CS---------------SSSSSSS---------------------------------------------SSSSS-----------------###------######------------
-----------------K---*-----------------*-----K---*-------------------TT---------------TT--------------TT--------------------------K---#----*--------####-----#######------------
------------*--------*-------*---------*---------*-----------*-------TT---------------TT---------*----TT----TT-----*-----TT-----------#----*-------#####----########--------F---
-M----------*--------B-------*---------*---------B-----------*-------TT---------------TT---------*----TT-k--TT-----*-----TT-----------#----*------######---#########--------#---
XXXXXXXXXXXXXXXXXXXXXXXXXXXXXXXXXXXXXXXXXXXXXXXXXXXXXXXXXXXXXXXXXX--XXXXXXXXXXXXXXXXXXXXXXXXXXXXXXXXXXXXXXXXXXXXXXXXXXXXXXXXXXXXXXXXXXXXXXXXXXXXX-XXXXXXXXXXXXXXXXXXXXXXXXXXXXXX
XXXXXXXXXXXXXXXXXXXXXXXXXXXXXXXXXXXXXXXXXXXXXXXXXXXXXXXXXXXXXXXXXX--XXXXXXXXXXXXXXXXXXXXXXXXXXXXXXXXXXXXXXXXXXXXXXXXXXXXXXXXXXXXXXXXXXXXXXXXXXXXX-XXXXXXXXXXXXXXXXXXXXXXXXXXXXXX